"filename", "language", "JSON", "Markdown", "JavaScript", "comment", "blank", "total"
"c:\Users\YOGA\Desktop\algorithm.js\DataStructure\graph.js", "JavaScript", 0, 0, 588, 149, 176, 913
"c:\Users\YOGA\Desktop\algorithm.js\DataStructure\hash.js", "JavaScript", 0, 0, 150, 11, 25, 186
"c:\Users\YOGA\Desktop\algorithm.js\DataStructure\queue.js", "JavaScript", 0, 0, 57, 0, 12, 69
"c:\Users\YOGA\Desktop\algorithm.js\DataStructure\stack.js", "JavaScript", 0, 0, 58, 0, 13, 71
"c:\Users\YOGA\Desktop\algorithm.js\DataStructure\tree.js", "JavaScript", 0, 0, 403, 55, 111, 569
"c:\Users\YOGA\Desktop\algorithm.js\README.md", "Markdown", 0, 0, 0, 0, 1, 1
"c:\Users\YOGA\Desktop\algorithm.js\algorithm\sort.js", "JavaScript", 0, 0, 55, 7, 9, 71
"c:\Users\YOGA\Desktop\algorithm.js\algorithm\string\huffman.js", "JavaScript", 0, 0, 124, 7, 6, 137
"c:\Users\YOGA\Desktop\algorithm.js\algorithm\string\kmp.js", "JavaScript", 0, 0, 30, 0, 4, 34
"c:\Users\YOGA\Desktop\algorithm.js\algorithm\string\lcs.js", "JavaScript", 0, 0, 28, 7, 3, 38
"c:\Users\YOGA\Desktop\algorithm.js\algorithm\string\lcss.js", "JavaScript", 0, 0, 29, 1, 1, 31
"c:\Users\YOGA\Desktop\algorithm.js\algorithm\string\lsd.js", "JavaScript", 0, 0, 21, 0, 2, 23
"c:\Users\YOGA\Desktop\algorithm.js\algorithm\string\rabinkarp.js", "JavaScript", 0, 0, 41, 0, 10, 51
"c:\Users\YOGA\Desktop\algorithm.js\index.js", "JavaScript", 0, 0, 14, 0, 3, 17
"c:\Users\YOGA\Desktop\algorithm.js\package.json", "JSON", 19, 0, 0, 0, 1, 20
"c:\Users\YOGA\Desktop\algorithm.js\test.js", "JavaScript", 0, 0, 4, 0, 0, 4
"Total", "-", 19, 0, 1602, 237, 377, 2235